111111111111111111
000000000000000001
100000000000000001
100000000000000001
100000000000000001
111111111111111101
